$$$ exec p1 : [./solution/filler_ai]
$$$ exec p2 : [./solution/filler_ai]
Anfield 10 15:
000 @..............
001 ...............
002 ...............
003 ...............
004 ...............
005 ...............
006 ...............
007 ...............
008 ...............
009 ..............$
Piece 1 1:
*
