$$$ exec p1 : [./solution/filler_ai]
$$$ exec p2 : [./solution/filler_ai]
Anfield 15 20:
000 @...................
001 ....................
002 ....................
003 ....................
004 ....................
005 ....................
006 ....................
007 ....................
008 ....................
009 ....................
010 ....................
011 ....................
012 ....................
013 ....................
014 ...................$
Piece 2 1:
**
